2000000000000000000000000200000000000000000000020000
0000000000000000000000000000000000000000000000000000
0000000000000000000000000000000000000000000000000000
0000000000000000000000000000000000000000000000000000
0000111100001111000011110000111100001111000011110000
0000111100001111000011110000111100001111000011110000
0000111100001111000011110000111100001111000011110000
0000111100001111000011110000111100001111000011110000
0000111100001111000011110000111100001111000011110000
0000111100001111000011110000111100001111000011110000
0000111100001111000011110000111100001111000011110000
0000111100001111000011110000111100001111000011110000
0000111100001111000011110000111100001111000011110000
0000111100001111000011110000111100001111000011110000
0000111100001111000011110000111100001111000011110000
0000111100001111000011110000111100001111000011110000
0000111100001111000011110000111100001111000011110000
0000111100001111000011110000111100001111000011110000
0000111100001111000000000000000000001111000011110000
0000111100001111000000000000000000001111000011110000
0000111100001111000000000000000000001111000011110000
0000111100001111000000000000000000001111000011110000
0000000000000000000000000000000000000000000000000000
0000000000000000000000000000000000000000000000000000
0000000000000000000000000000000000000000000000000000
0000000000000000000000000000000000000000000000000000
0000000011111111000000000000000000001111111100000000
0000000011111111000000000000000000001111111100000000
7777000011111111000000000000000000001111111100007777
7777000011111111000000000000000000001111111100007777
0000000000000000000011110000111100000000000000000000
0000000000000000000011110000111100000000000000000000
0000000000000000000011111111111100000000000000000000
0000000000000000000011111111111100000000000000000000
0000111100001111000011111111111100001111000011110000
0000111100001111000011111111111100001111000011110000
0000111100001111000011110000111100001111000011110000
0000111100001111000011110000111100001111000011110000
0000111100001111000011110000111100001111000011110000
0000111100001111000011110000111100001111000011110000
0000111100001111000011110000111100001111000011110000
0000111100001111000011110000111100001111000011110000
0000111100001111000000000000000000001111000011110000
0000111100001111000000000000000000001111000011110000
0000111100001111000000000000000000001111000011110000
0000111100001111000000000000000000001111000011110000
0000111100001111000000111111110000001111000011110000
0000111100001111000000113000110000001111000011110000
0000000000000000400000110000110000000000000000000000
0000000000000000000000110000110000000000000000000000
0000000000000000000000110000110000000000000000000000
0000000000000000000000110000110000000000000000000000