2000000000000000000000000000000077777777777777770000
0000000000000000000000000000000077777777777777770000
0000000000000000000000000000000077777777777777770000
0000000000000000000000000000000077777777777777770000
0000111100000000000000000000000077770000000077770000
0000111100000000000000000000000077770000000077770000
0000111100000000000000000000000077770000000077770000
0000111100000000000000000000000077770000000077770000
1111000011110000000000001111111111111111000077770000
1111000011110000000000001111111111111111000077770000
1111000011110000000000001111111111111111000077770000
1111000011110000000000001111111111111111000077770000
0000111100001111000000001111000000001111777777770000
0000111100001111000000001111000000001111777777770000
0000111100001111000000001111000000001111777777770000
0000111100001111000000001111000000001111777777770000
0000000011110000000077771111000000001111000000000000
0000000011110000000077771111000000001111000000000000
0000000011110000000077771111000000001111000000000000
0000000011110000000077771111000000001111000000000000
0000000000000000777700001111777711111111000000000000
0000000000000000777700001111777711111111000000000000
0000000000000000777700001111777711111111000000000000
0000000000000000777700001111777711111111000000000000
0000000011111111777711110000777700000000000000000000
0000000011111111777711110000777700000000000000000000
0000000011111111777711110000777700000000000000000000
0000000011111111777711110000777700000000000000000000
0000000011110000000011117777000000000000000000000000
0000000011110000000011117777000000000000000000000000
0000000011110000000011117777000000000000000000000000
0000000011110000000011117777000000000000000000000000
7777777777770000000011110000000011111111000000000000
7777777777770000000011110000000011111111000000000000
7777777777770000000011110000000011111111000000000000
7777777777770000000011110000000011111111000000000000
7777000011111111111111110000000011111111000000000000
7777000011111111111111110000000011111111000000000000
7777000011111111111111110000000011111111000000000000
7777000011111111111111110000000011111111000000000000
7777000000007777000000000000000000007777111111110000
7777000000007777000000000000000000007777111111110000
7777000000007777000000000000000000007777111111110000
7777000000007777000000000000000000007777111111110000
0000777777777777000000000000000000000000111177777777
0000777777777777000000000000000000000000111177777777
0000777777777777000000111111110000000000111177777777
0000777777777777000000111111110000000000111177777777
0000000000000000400000113000110000000000000077777777
0000000000000000000000110000110000000000000077777777
0000000000000000000000110000110000000000000077777777
0000000000000000000000110000110000000000000077777777